3,3,3,3,3,3,3,3,3,3,3,3,3,3,3,3,3,3,3,3,3,
3,0,0,0,0,0,0,0,0,0,3,0,0,0,0,0,0,0,0,0,3,
3,0,3,3,3,0,3,3,3,0,3,0,3,3,3,0,3,3,3,0,3,
3,2,3,3,3,0,3,3,3,0,3,0,3,3,3,0,3,3,3,2,3,
3,0,3,3,3,0,3,3,3,0,3,0,3,3,3,0,3,3,3,0,3,
3,0,0,0,0,0,0,0,0,0,0,0,0,0,0,0,0,0,0,0,3,
3,0,3,3,3,0,3,0,3,3,3,3,3,0,3,0,3,3,3,0,3,
3,0,3,3,3,0,3,0,3,3,3,3,3,0,3,0,3,3,3,0,3,
3,0,0,0,0,0,3,0,0,0,3,0,0,0,3,0,0,0,0,0,3,
3,3,3,3,3,0,3,3,3,0,3,0,3,3,3,0,3,3,3,3,3,
3,3,3,3,3,0,3,0,0,0,0,0,0,0,3,0,3,3,3,3,3,
3,3,3,3,3,0,3,0,3,3,4,3,3,0,3,0,3,3,3,3,3,
3,3,3,3,3,0,3,0,3,0,9,0,3,0,3,0,3,3,3,3,3,
0,0,0,0,0,0,0,0,3,6,7,8,3,0,0,0,0,0,0,0,0,
3,3,3,3,3,0,3,0,3,3,3,3,3,0,3,0,3,3,3,3,3,
3,3,3,3,3,0,3,0,0,0,0,0,0,0,3,0,3,3,3,3,3,
3,3,3,3,3,0,3,0,3,3,3,3,3,0,3,0,3,3,3,3,3,
3,3,3,3,3,0,3,0,3,3,3,3,3,0,3,0,3,3,3,3,3,
3,0,0,0,0,0,0,0,0,0,3,0,0,0,0,0,0,0,0,0,3,
3,0,3,3,3,0,3,3,3,0,3,0,3,3,3,0,3,3,3,0,3,
3,2,0,0,3,1,1,0,0,0,5,0,0,0,0,0,3,0,0,2,3,
3,3,3,0,3,0,3,0,3,3,3,3,3,0,3,0,3,0,3,3,3,
3,3,3,0,3,0,3,0,3,3,3,3,3,0,3,0,3,0,3,3,3,
3,0,0,0,0,0,3,0,0,0,3,0,0,0,3,0,0,0,0,0,3,
3,0,3,3,3,3,3,3,3,0,3,0,3,3,3,3,3,3,3,0,3,
3,0,0,0,0,0,0,0,0,0,0,0,0,0,0,0,0,0,0,0,3,
3,3,3,3,3,3,3,3,3,3,3,3,3,3,3,3,3,3,3,3,3,